You awake with no memories of who you are.

Absurdist Octo-shrimp
An Interactive Fiction by Ethan Saff
Release 1 / Serial number 180326 / Inform 7 build 6M62 (I6/v6.33 lib 6/12N) SD

Log Cabin
A sparsely furnished log cabin, lit by electrical lighting. The door is to the east.

You can see a wooden trapdoor, a door to the cabin, three electric lights (providing light), a light switch, a moth-eaten old bed and an old wooden chest (closed) here.

>down
(first opening the wooden trapdoor)
It seems to be locked.

>open
What do you want to open?

>open chest
You open the old wooden chest, revealing ten crackers, three flashlights and a small metal key.

>take key
Taken.

>take flashlight
Taken.

>take cracker
You're carrying too many things already.

>eat cracker
(first taking the cracker)
You're carrying too many things already.

>drop flashlight
Dropped.

>eat cracker
(first taking the cracker)
You eat the cracker. Not bad.

>g
(first taking the cracker)
You eat the cracker. Not bad.

>g
(first taking the cracker)
You eat the cracker. Not bad.

>g
You can't see any such thing.

>look
Log Cabin
A sparsely furnished log cabin, lit by electrical lighting. The door is to the east.

You can see a flashlight, three electric lights (providing light), a light switch, a moth-eaten old bed, an old wooden chest (in which are two flashlights), a door to the cabin and a wooden trapdoor here.

You begin to feel rather tired.

>examine trapdoor
(the small metal key)
It seems this key will fit the trapdoor in the log cabin.

* * *

>down
(first opening the wooden trapdoor)
It seems to be locked.

>test stuff
(Testing.)

>[1] open chest
You open the old wooden chest, revealing ten crackers, three flashlights and a basement key.

>[2] take key
Taken.

>[3] take flashlight
Taken.

>[4] switch on flashlight
You switch the flashlight on.

>[5] unlock trapdoor with key
You unlock the wooden trapdoor.

>[6] down
(first opening the wooden trapdoor)

Cellar
An old cellar. Suprisingly, the food here has been kept relatively well preserved.

You can see a wooden trapdoor, a table (on which is a black purse (in which is a set of lockpicks)) and various foodstuffs here.

>[7] drop all
flashlight: Dropped.
basement key: Dropped.

>[8] open purse
That's already open.

>[9] put key in purse
(first taking the basement key)
You put the basement key into the black purse.

>[10] take purse
You close the black purse.

Taken.

>[11] up

Log Cabin
A sparsely furnished log cabin, lit by electrical lighting. The door is to the east.

You can see a wooden trapdoor, three electric lights (providing light), a light switch, a moth-eaten old bed, an old wooden chest (in which are ten crackers and two flashlights) and a door to the cabin here.

* * *

You awake with no memories of who you are.

Absurdist Octo-shrimp
An Interactive Fiction by Ethan Saff
Release 1 / Serial number 180326 / Inform 7 build 6M62 (I6/v6.33 lib 6/12N) SD

Log Cabin
A sparsely furnished log cabin, lit by electrical lighting. The door is to the east.

You can see a wooden trapdoor, a door to the cabin, three electric lights (providing light), a light switch, a moth-eaten old bed and an old wooden chest (closed) here.

>e
(first opening the log cabin door)
It seems to be locked.

* * *

>e
When you try to go that way, you blunder into a wall.

* * *

>e
(first opening the log cabin door)
It seems to be locked.

>w
You can't go that way.

* * *

You awake with no memories of who you are.

Absurdist Octo-shrimp
An Interactive Fiction by Ethan Saff
Release 1 / Serial number 180326 / Inform 7 build 6M62 (I6/v6.33 lib 6/12N) SD

Log Cabin
A sparsely furnished log cabin, lit by electrical lighting. The door is to the east.

You can see a wooden trapdoor, a door to the cabin, three electric lights (providing light), a light switch, a moth-eaten old bed and an old wooden chest (closed) here.

>examine self
You are who you are.

* * *

You awake with no memories of who you are.

Absurdist Octo-shrimp
An Interactive Fiction by Ethan Saff
Release 1 / Serial number 180326 / Inform 7 build 6M62 (I6/v6.33 lib 6/12N) SD

Log Cabin
A sparsely furnished log cabin, lit by electrical lighting. The door is to the east.

You can see a wooden trapdoor, a door to the cabin, three electric lights (providing light), a light switch, a moth-eaten old bed and an old wooden chest (closed) here.

>get on bed
You get onto the moth-eaten old bed.

>sleep
You try to rest for a while, but can't get to sleep.

>sleep
You try to rest for a while, but can't get to sleep.

>sleep
You sleep relatively soundly, and awake the next morning

* * *

You awake with no memories of who you are.

Absurdist Octo-shrimp
An Interactive Fiction by Ethan Saff
Release 1 / Serial number 180326 / Inform 7 build 6M62 (I6/v6.33 lib 6/12N) SD

Log Cabin
A sparsely furnished log cabin, lit by electrical lighting. The door is to the east.

You can see a wooden trapdoor, a door to the cabin, three electric lights (providing light), a light switch, a moth-eaten old bed and an old wooden chest (closed) here.

>i
You are carrying nothing.

* * *

You awake with no memories of who you are.

Absurdist Octo-shrimp
An Interactive Fiction by Ethan Saff
Release 1 / Serial number 180326 / Inform 7 build 6M62 (I6/v6.33 lib 6/12N) SD

Log Cabin
A sparsely furnished log cabin, lit by electrical lighting. The door is to the east.

You can see a wooden trapdoor, a door to the cabin, three electric lights (providing light), a light switch, a moth-eaten old bed and an old wooden chest (closed) here.

>n
You can't go that way.

>s
You can't go that way.

>e
(first opening the the door to the cabin.)
It seems to be locked.

>take key
You can't see any such thing.

* * *

You awake with no memories of who you are.

Absurdist Octo-shrimp
An Interactive Fiction by Ethan Saff
Release 1 / Serial number 180326 / Inform 7 build 6M62 (I6/v6.33 lib 6/12N) SD

Log Cabin
A sparsely furnished log cabin, lit by electrical lighting. The door is to the east.

You can see a wooden trapdoor, a door to the cabin, three electric lights (providing light), a light switch, a moth-eaten old bed and an old wooden chest (closed) here.

>open chest
You open the old wooden chest, revealing ten crackers, three flashlights and a basement key.

>take key
Taken.

>open trapdoor
It seems to be locked.

>unlock trapdoor
(with the basement key)
You unlock the wooden trapdoor.

>down
(first opening the wooden trapdoor)
You can't, since the wooden trapdoor leads nowhere.

* * *

>take key
Taken.

>unlock door
(with the basement key)
That doesn't seem to fit the lock.

>unlock trapdoor
(with the basement key)
You unlock the wooden trapdoor.

>down
(first opening the wooden trapdoor)

Darkness
It is pitch dark, and you can't see a thing.

>up
Log Cabin
A sparsely furnished log cabin, lit by electrical lighting. The door is to the east.

You can see a wooden trapdoor, three electric lights (providing light), a light switch, a moth-eaten old bed, an old wooden chest (in which are ten crackers and three flashlights) and a door to the cabin here.

>take flashlight
Taken.

>down
Darkness
It is pitch dark, and you can't see a thing.

>switch on flashlight
You switch the flashlight on.

Cellar
An old cellar. Suprisingly, the food here has been kept relatively well preserved.

You can see a wooden trapdoor and sundry assortment of edible goods here.

>drop key
Dropped.

>take sundry
You can't see any such thing.

>take various foodstuffs
Taken.

>i
You are carrying:
  sundry assortment of edible goods
  a flashlight (providing light)

* * *

You awake with no memories of who you are.

Absurdist Octo-shrimp
An Interactive Fiction by Ethan Saff
Release 1 / Serial number 180326 / Inform 7 build 6M62 (I6/v6.33 lib 6/12N) SD

Log Cabin
A sparsely furnished log cabin, lit by electrical lighting. The door is to the east.

You can see a wooden trapdoor, a door to the cabin, three electric lights (providing light), a light switch, a moth-eaten old bed and an old wooden chest (closed) here.

>open trapdoor
It seems to be locked.

>open chest
You open the old wooden chest, revealing ten crackers, three flashlights and a basement key.

>take flashlight
Taken.

>take key
Taken.

>unlock trapdoor
What do you want to unlock the wooden trapdoor with?

>key
You unlock the wooden trapdoor.

>down
(first opening the wooden trapdoor)

Darkness
It is pitch dark, and you can't see a thing.

>switch on flashlight
You switch the flashlight on.

Cellar
An old cellar. Suprisingly, the food here has been kept relatively well preserved.

You can see a wooden trapdoor and various foodstuffs here.

>take foodstuffs
You're carrying too many things already.

>all
That's not a verb I recognise.

>drop key
Dropped.

>take foodstuffs
Taken.

* * *

You awake with no memories of who you are.

Absurdist Octo-shrimp
An Interactive Fiction by Ethan Saff
Release 1 / Serial number 180326 / Inform 7 build 6M62 (I6/v6.33 lib 6/12N) SD

Log Cabin
A sparsely furnished log cabin, lit by electrical lighting. The door is to the east.

You can see a wooden trapdoor, a door to the cabin, three electric lights (providing light), a light switch, a moth-eaten old bed and an old wooden chest (closed) here.

>outside
(first opening the door to the cabin)
It seems to be locked.

>take bed
That's fixed in place.

* * *

You awake with no memories of who you are.

Absurdist Octo-shrimp
An Interactive Fiction by Ethan Saff
Release 1 / Serial number 180326 / Inform 7 build 6M62 (I6/v6.33 lib 6/12N) SD

Log Cabin
A sparsely furnished log cabin, lit by electrical lighting. The door is to the east.

You can see a wooden trapdoor, a door to the cabin, three electric lights (providing light), a light switch, a moth-eaten old bed and an old wooden chest (closed) here.

>s
You can't go that way.

>look
Long-Forgotten Highway
You are traveling along a dirt path. It seems to have been decades since anyone else set foot on this road. The road continues to the north and south.

* * *

You awake with no memories of who you are.

Absurdist Octo-shrimp
An Interactive Fiction by Ethan Saff
Release 1 / Serial number 180326 / Inform 7 build 6M62 (I6/v6.33 lib 6/12N) SD

Log Cabin
A sparsely furnished log cabin, lit by electrical lighting. The door is to the east.

You can see a wooden trapdoor, a door to the cabin, three electric lights (providing light), a light switch, a moth-eaten old bed and an old wooden chest (closed) here.

>sleep
You try to rest for a while, but can't get to sleep.

>get on bed
You get onto the moth-eaten old bed.

* * *

>sleep
You try to rest for a while, but can't get to sleep.

>sleep
You sleep relatively soundly, and awaken the next morning.

>z
Time passes.

>z
Time passes.

>wait
Time passes.

* * *

>sleep
You try to rest for a while, but can't get to sleep.

>z
Time passes.

I beg your pardon?

>z
Time passes.

* * *

>sleep
You try to rest for a while, but can't get to sleep.

>test stuff
(Testing.)

>[1] open chest
You open the old wooden chest, revealing ten crackers, three flashlights and a basement key.

>[2] take key
Taken.

>[3] take flashlight
Taken.

>[4] switch on flashlight
You switch the flashlight on.

>[5] unlock trapdoor with key
You unlock the wooden trapdoor.

>[6] down
(first getting off the moth-eaten old bed)
(first opening the wooden trapdoor)

Cellar
An old cellar. Suprisingly, the food here has been kept relatively well preserved.

You can see a wooden trapdoor, a table (on which is a black purse (in which is a set of lockpicks)) and various foodstuffs here.

>[7] drop all
flashlight: Dropped.
basement key: Dropped.

>[8] open purse
That's already open.

>[9] put key in purse
(first taking the basement key)
You put the basement key into the black purse.

>[10] take purse
You close the black purse.

Taken.

>[11] up

Log Cabin
A sparsely furnished log cabin, lit by electrical lighting. The door is to the east.

You can see a wooden trapdoor, a door to the cabin, three electric lights (providing light), a light switch, a moth-eaten old bed and an old wooden chest (in which are ten crackers and two flashlights) here.

>[12] open purse
Dropped.

You open the black purse, revealing a basement key and a set of lockpicks.

>[13] take lockpicks
Taken.

>[14] unlock door with lockpicks
You fiddle a bit, and the door to the cabin is unlocked.

>[15] put lockpicks in purse
You put the set of lockpicks into the black purse.

>[16] take purse
You close the black purse.

Taken.

>[17] outside
(first opening the door to the cabin)

Highway
A dusty footpath that extends to the north and south.

You can see a door to the cabin here.

You see the sun set behind the horizon, and darkness falls across the land.

>inside
Log Cabin
A sparsely furnished log cabin, lit by electrical lighting. The door is to the east.

You can see a door to the cabin, a wooden trapdoor, three electric lights (providing light), a light switch, a moth-eaten old bed and an old wooden chest (in which are ten crackers and two flashlights) here.

>outside
Darkness
It is pitch dark, and you can't see a thing.

>i
You are carrying:
  a black purse (closed)

>open purse
Dropped.

You open the black purse, revealing a set of lockpicks and a basement key.

>take lockpicks
You can't see any such thing.

>inside
Log Cabin
A sparsely furnished log cabin, lit by electrical lighting. The door is to the east.

You can see a door to the cabin, a wooden trapdoor, three electric lights (providing light), a light switch, a moth-eaten old bed and an old wooden chest (in which are ten crackers and two flashlights) here.

>down
Cellar
An old cellar. Suprisingly, the food here has been kept relatively well preserved.

You can see a wooden trapdoor, a flashlight (providing light), a table and various foodstuffs here.

>take flashlight
Taken.

>up
Log Cabin
A sparsely furnished log cabin, lit by electrical lighting. The door is to the east.

You can see a wooden trapdoor, a door to the cabin, three electric lights (providing light), a light switch, a moth-eaten old bed and an old wooden chest (in which are ten crackers and two flashlights) here.

>outside
Highway
A dusty footpath that extends to the north and south.

You can see a door to the cabin and a black purse (in which are a set of lockpicks and a basement key) here.

>i
You are carrying:
  a flashlight (providing light)

>take purse
You close the black purse.

Taken.

>s
Highway
A dusty footpath that extends to the north and south.

>s
Highway
A dusty footpath that extends to the north and south.

>s
Highway
A dusty footpath that extends to the north and south.

You can see a bed here.

>s
Highway
A dusty footpath that extends to the north and south.

You can see a door to the cabin here.

>s
Highway
A dusty footpath that extends to the north and south.

>s
Highway
A dusty footpath that extends to the north and south.

You see the sun peek over the horizon, and light once again greets your weary eyes.

>s
Highway
A dusty footpath that extends to the north and south.

You can see a bed here.

* * *

>s
Highway
A dusty footpath that extends to the north and south.

You can see a door to the cabin here.

I beg your pardon?

* * *

You awake with no memories of who you are.

Absurdist Octo-shrimp
An Interactive Fiction by Ethan Saff
Release 1 / Serial number 180326 / Inform 7 build 6M62 (I6/v6.33 lib 6/12N) SD

Log Cabin
A sparsely furnished log cabin, lit by electrical lighting. The door is to the east.

You can see a wooden trapdoor, a door to the cabin, three electric lights (providing light), a light switch, a moth-eaten old bed and an old wooden chest (closed) here.

>south
The cabin has walls, you know.

>outsid
That's not a verb I recognise.

>outside
The cabin has walls, you know.

>inside
The cabin has walls, you know.

>enter
You must supply a noun.

>examine self
As good-looking as ever.

>wear
(yourself)
(first taking yourself)
You are always self-possessed.

>wear nothing
You can't see any such thing.

>what am i wearing
That's not a verb I recognise.

* * *

You awake with no memories of who you are.

Absurdist Octo-shrimp
An Interactive Fiction by Ethan Saff
Release 1 / Serial number 180326 / Inform 7 build 6M62 (I6/v6.33 lib 6/12N) SD

Log Cabin
A sparsely furnished log cabin, lit by electrical lighting. The door is to the east.

You can see a wooden trapdoor, a door to the cabin, three electric lights (providing light), a light switch, a moth-eaten old bed and an old wooden chest (closed) here.

>stuff
That's not a verb I recognise.

>test stuff
(Testing.)

>[1] open chest
You open the old wooden chest, revealing ten crackers, three flashlights and a basement key.

>[2] take key
Taken.

>[3] take flashlight
Taken.

>[4] switch on flashlight
You switch the flashlight on.

>[5] unlock trapdoor with key
You unlock the wooden trapdoor.

>[6] down
(first opening the wooden trapdoor)

Cellar
An old cellar. Suprisingly, the food here has been kept relatively well preserved.

You can see a wooden trapdoor, a table (on which is a black purse (in which is a set of lockpicks)) and various foodstuffs here.

>[7] drop all
flashlight: Dropped.
basement key: Dropped.

>[8] open purse
That's already open.

>[9] put key in purse
(first taking the basement key)
You put the basement key into the black purse.

>[10] up

Log Cabin
A sparsely furnished log cabin, lit by electrical lighting. The door is to the east.

You can see a wooden trapdoor, three electric lights (providing light), a light switch, a moth-eaten old bed, an old wooden chest (in which are ten crackers and two flashlights) and a door to the cabin here.

>[11] I beg your pardon?
I beg your pardon?

>i
You are carrying nothing.

* * *

You awake with no memories of who you are.

Absurdist Octo-shrimp
An Interactive Fiction by Ethan Saff
Release 1 / Serial number 180326 / Inform 7 build 6M62 (I6/v6.33 lib 6/12N) SD

Log Cabin
A sparsely furnished log cabin, lit by electrical lighting. The door is to the east.

You can see a wooden trapdoor, a door to the cabin, three electric lights (providing light), a light switch, a moth-eaten old bed and an old wooden chest (closed) here.

>switch off
[** Programming error: tried to find the "." of (something) **]

[** Programming error: tried to find the "." of (something) **]

[** Programming error: tried to find the "." of (something) **]

[** Programming error: tried to find the "." of (something) **]

[** Programming error: tried to find the "." of (something) **]

[** Programming error: tried to find the "." of (something) **]

[** Programming error: tried to find the "parent" of nothing **]

[** Programming error: tried to find the "parent" of nothing **]

[** Programming error: tried to test "has" or "hasnt" of nothing **]

[** Programming error: tried to test "has" or "hasnt" of nothing **]

[** Programming error: tried to test "has" or "hasnt" of nothing **]

[** Programming error: tried to test "has" or "hasnt" of nothing **]

[** Programming error: tried to test "has" or "hasnt" of nothing **]

[** Programming error: tried to test "has" or "hasnt" of nothing **]

[** Programming error: tried to test "has" or "hasnt" of nothing **]
What do you want to switch off?

>switch off switch
[** Programming error: tried to find the "." of (something) **]

[** Programming error: tried to find the "." of (something) **]

[** Programming error: tried to find the "." of (something) **]

[** Programming error: tried to find the "." of (something) **]

[** Programming error: tried to find the "." of (something) **]
You switch the light switch off.

It is now pitch dark in here!

* * *

You awake with no memories of who you are.

Absurdist Octo-shrimp
An Interactive Fiction by Ethan Saff
Release 1 / Serial number 180326 / Inform 7 build 6M62 (I6/v6.33 lib 6/12N) SD

Log Cabin
A sparsely furnished log cabin, lit by electrical lighting. The door is to the east.

You can see a wooden trapdoor, a door to the cabin, three electric lights (providing light), a light switch, a moth-eaten old bed and an old wooden chest (closed) here.

>switch off light
Which do you mean, an electric light or the light switch?

>switch
(the light switch)
You switch the light switch off.

It is now pitch dark in here!

>look
Darkness
It is pitch dark, and you can't see a thing.

>switch on light
You switch the light switch on.

Log Cabin
A sparsely furnished log cabin, lit by electrical lighting. The door is to the east.

You can see three electric lights (providing light), a light switch, a moth-eaten old bed, an old wooden chest (closed) and a door to the cabin here.

* * *

You awake with no memories of who you are.

Absurdist Octo-shrimp
An Interactive Fiction by Ethan Saff
Release 1 / Serial number 180326 / Inform 7 build 6M62 (I6/v6.33 lib 6/12N) SD

Log Cabin
A sparsely furnished log cabin, lit by electrical lighting. The door is to the east.

You can see a wooden trapdoor, a door to the cabin, three electric lights (providing light), a light switch, a moth-eaten old bed and an old wooden chest (closed) here.

>switch off light switch
You switch the light switch off.

>switch on light switch
You switch the light switch on.

>look
Log Cabin
A sparsely furnished log cabin, lit by electrical lighting. The door is to the east.

You can see three electric lights, a light switch, a moth-eaten old bed, an old wooden chest (closed) and a door to the cabin here.

>switch off light switch
You switch the light switch off.

>look
Log Cabin
A sparsely furnished log cabin, lit by electrical lighting. The door is to the east.

You can see three electric lights (providing light), a light switch, a moth-eaten old bed, an old wooden chest (closed) and a door to the cabin here.

* * *

You awake with no memories of who you are.

Absurdist Octo-shrimp
An Interactive Fiction by Ethan Saff
Release 1 / Serial number 180326 / Inform 7 build 6M62 (I6/v6.33 lib 6/12N) SD

Log Cabin
A sparsely furnished log cabin, lit by electrical lighting. The door is to the east.

You can see a wooden trapdoor, a door to the cabin, three electric lights (providing light), a light switch, a moth-eaten old bed and an old wooden chest (closed) here.

>switch off switch
You switch the light switch off.

It is now pitch dark in here!

>switch on switch
You can't see any such thing.

* * *

You awake with no memories of who you are.

Absurdist Octo-shrimp
An Interactive Fiction by Ethan Saff
Release 1 / Serial number 180326 / Inform 7 build 6M62 (I6/v6.33 lib 6/12N) SD

Log Cabin
A sparsely furnished log cabin, lit by electrical lighting. The door is to the east.

You can see a wooden trapdoor, a door to the cabin, three electric lights (providing light), a light switch, a moth-eaten old bed and an old wooden chest (closed) here.

>take electric lights
That can't contain things.

>take all
There are none at all available!

>take electric light
That's fixed in place.

* * *

You awake with no memories of who you are.

Absurdist Octo-shrimp
An Interactive Fiction by Ethan Saff
Release 1 / Serial number 180326 / Inform 7 build 6M62 (I6/v6.33 lib 6/12N) SD

Log Cabin
A sparsely furnished log cabin, lit by electrical lighting. The door is to the east.

You can see a wooden trapdoor, a door to the cabin, three electric lights (providing light), a light switch, a moth-eaten old bed and an old wooden chest (closed) here.

>test entercellar
(Testing.)

>[1] open chest
You open the old wooden chest, revealing ten crackers, three flashlights and a basement key.

>[2] take key
Taken.

>[3] take flashlight
Taken.

>[4] switch on flashlight
You switch the flashlight on.

>[5] unlock trapdoor with key
You unlock the wooden trapdoor.

>[6] down
(first opening the wooden trapdoor)

Cellar
An old cellar. Suprisingly, the food here has been kept relatively well preserved.

You can see a wooden trapdoor, a table (on which is a black purse (in which is a set of lockpicks)) and various foodstuffs here.

>drop key
Dropped.

>eat various
You set to, and soon the food is gone.

>list
That's not a verb I recognise.

>look
Cellar
An old cellar. Suprisingly, the food here has been kept relatively well preserved.

You can see a basement key and a wooden trapdoor here.

>examine self
As good-looking as ever.

>examine key
It seems this key will fit the trapdoor in the log cabin.

>examine trapdoor
An old trapdoor, with its hinges badly rusted.

>examine room
You can't see any such thing.

>examine
(the flashlight)
The flashlight is currently switched on.

>i
You are carrying:
  a flashlight (providing light)

* * *

>take foodstuffs
Taken.

>eat foodstuffs
You eat various foodstuffs. Not bad.

* * *

>test entercellar
(Testing.)

>[1] open chest
You open the old wooden chest, revealing ten crackers, three flashlights and a basement key.

>[2] take key
Taken.

>[3] take flashlight
Taken.

>[4] switch on flashlight
You switch the flashlight on.

>[5] unlock trapdoor with key
You unlock the wooden trapdoor.

>[6] down
(first opening the wooden trapdoor)

Cellar
An old cellar. Suprisingly, the food here has been kept relatively well preserved.

You can see a wooden trapdoor, a table (on which is a black purse (in which is a set of lockpicks)) and various foodstuffs here.

>i
You are carrying:
  a flashlight (providing light)
  a basement key

>drop key
Dropped.

>take purse
You close the black purse.

Taken.

>put key in purse
(first taking the basement key)
You're carrying too many things already.

>open purse
Dropped.

You open the black purse, revealing a set of lockpicks.

>put key in purse
(first taking the basement key)
You put the basement key into the black purse.

>put food in purse
(first taking various foodstuffs)
You put various foodstuffs into the black purse.

>i
You are carrying:
  a flashlight (providing light)

* * *

>take purse
You close the black purse.

Taken.

>up
Log Cabin
A sparsely furnished log cabin, lit by electrical lighting. The door is to the east.

You can see a wooden trapdoor, three electric lights (providing light), a light switch, a moth-eaten old bed, an old wooden chest (in which are ten crackers and two flashlights) and a door to the cabin here.

>i
You are carrying:
  a black purse (closed)
  a flashlight (providing light)

>open purse
Dropped.

You open the black purse, revealing various foodstuffs, a basement key and a set of lockpicks.

You begin to feel rather tired.

>sleep
You try to rest for a while, but can't get to sleep.

* * *

>test entercellar
(Testing.)

>[1] open chest
You open the old wooden chest, revealing ten crackers, three flashlights and a basement key.

>[2] take key
Taken.

>[3] take flashlight
Taken.

>[4] switch on flashlight
You switch the flashlight on.

>[5] unlock trapdoor with key
You unlock the wooden trapdoor.

>[6] down
(first opening the wooden trapdoor)

Cellar
An old cellar. Suprisingly, the food here has been kept relatively well preserved.

You can see a wooden trapdoor, a table (on which is a black purse (in which is a set of lockpicks)) and various foodstuffs here.

>take sack
You're carrying too many things already.

>drop key
Dropped.

>take sack
Taken.

>i
You are carrying:
  a grocery sack
  a flashlight (providing light)

>take foodstuffs
You're carrying too many things already.

>put foodstuffs in sack
(first taking various foodstuffs)
You're carrying too many things already.

* * *

>test entercellar
(Testing.)

>[1] open chest
You open the old wooden chest, revealing ten crackers, three flashlights and a basement key.

>[2] take key
Taken.

>[3] take flashlight
Taken.

>[4] switch on flashlight
You switch the flashlight on.

>[5] unlock trapdoor with key
You unlock the wooden trapdoor.

>[6] down
(first opening the wooden trapdoor)

Cellar
An old cellar. Suprisingly, the food here has been kept relatively well preserved.

You can see a wooden trapdoor, a table (on which is a black purse (in which is a set of lockpicks)) and various foodstuffs here.

>take tackle box
You close the tackle box.

You're carrying too many things already.

>drop key
Dropped.

>open tackle box
You open the tackle box.

>take tackle box
You close the tackle box.

Taken.

>open tackle box
Dropped.

You open the tackle box.

* * *

You awake with no memories of who you are.

Absurdist Octo-shrimp
An Interactive Fiction by Ethan Saff
Release 1 / Serial number 180326 / Inform 7 build 6M62 (I6/v6.33 lib 6/12N) SD

Log Cabin
A sparsely furnished log cabin, lit by electrical lighting. The door is to the east.

You can see a wooden trapdoor, a door to the cabin, three electric lights (providing light), a light switch, a moth-eaten old bed and an old wooden chest (closed) here.

>test stuff
(Testing.)

>[1] open chest
You open the old wooden chest, revealing ten crackers, three flashlights and a basement key.

>[2] take key
Taken.

>[3] take flashlight
Taken.

>[4] switch on flashlight
You switch the flashlight on.

>[5] unlock trapdoor with key
You unlock the wooden trapdoor.

>[6] down
(first opening the wooden trapdoor)

Cellar
An old cellar. Suprisingly, the food here has been kept relatively well preserved.

You can see a wooden trapdoor, a table (on which is a black purse (in which is a set of lockpicks)) and various foodstuffs here.

>[7] drop all
flashlight: Dropped.
basement key: Dropped.

>[8] open purse
That's already open.

>[9] put key in purse
(first taking the basement key)
You put the basement key into the black purse.

>[10] take purse
You close the black purse.

Taken.

>[11] up

Log Cabin
A sparsely furnished log cabin, lit by electrical lighting. The door is to the east.

You can see a wooden trapdoor, a door to the cabin, three electric lights (providing light), a light switch, a moth-eaten old bed and an old wooden chest (in which are ten crackers and two flashlights) here.

>[12] open purse
Dropped.

You open the black purse, revealing a basement key and a set of lockpicks.

>[13] take lockpicks
Taken.

>[14] unlock door with lockpicks
You fiddle a bit, and the door to the cabin is unlocked.

>[15] put lockpicks in purse
You put the set of lockpicks into the black purse.

>[16] take purse
You close the black purse.

Taken.

>[17] outside
(first opening the door to the cabin)

Highway
A dusty footpath that extends to the north and south.

You can see a door to the cabin here.

>i
You are carrying:
  a black purse (closed)

>sleep
You try to rest for a while, but can't get to sleep.

* * *

>sleep
You sleep relatively soundly, and awaken the next morning.

>i
You are carrying:
  a black purse (closed)

* * *

>n
Highway
A dusty footpath that extends to the north and south.

You can see a bed here.

You see the sun set behind the horizon, and darkness falls across the land.

It is now pitch dark in here!

>n
Darkness
It is pitch dark, and you can't see a thing.

>n
Darkness
It is pitch dark, and you can't see a thing.

>inside
You can't go that way.

>n
Darkness
It is pitch dark, and you can't see a thing.

>n
Darkness
It is pitch dark, and you can't see a thing.

You see the sun peek over the horizon, and light once again greets your weary eyes.

Highway
A dusty footpath that extends to the north and south.

>n
Highway
A dusty footpath that extends to the north and south.

>n
Highway
A dusty footpath that extends to the north and south.

You can see a door to the cabin here.

>inside
You can't go that way.

* * *

>n
Darkness
It is pitch dark, and you can't see a thing.

>s
Darkness
It is pitch dark, and you can't see a thing.

>inside
You can't go that way.

>w
You can't go that way.

>z
Time passes.

>sleep
There's nowhere to lay your head.

>sleep
There's nowhere to lay your head.

>z
Time passes.

>z
Time passes.

You see the sun peek over the horizon, and light once again greets your weary eyes.

Highway
A dusty footpath that extends to the north and south.

>s
Highway
A dusty footpath that extends to the north and south.

You can see a door to the cabin here.

>n
Highway
A dusty footpath that extends to the north and south.

>s
Highway
A dusty footpath that extends to the north and south.

You can see a door to the cabin here.

>inside
Log Cabin
A sparsely furnished log cabin, lit by electrical lighting. The door is to the east.

You can see a door to the cabin, a wooden trapdoor, three electric lights (providing light), a light switch, a moth-eaten old bed and an old wooden chest (in which are ten crackers and two flashlights) here.

>outside
Highway
A dusty footpath that extends to the north and south.

You can see a door to the cabin here.

>inside
Log Cabin
A sparsely furnished log cabin, lit by electrical lighting. The door is to the east.

You can see a door to the cabin, a wooden trapdoor, three electric lights (providing light), a light switch, a moth-eaten old bed and an old wooden chest (in which are ten crackers and two flashlights) here.

>sleep
You try to rest for a while, but can't get to sleep.

* * *

>z
Time passes.

>outside
(first getting off the moth-eaten old bed)

Highway
A dusty footpath that extends to the north and south.

You can see a door to the cabin here.

>z
Time passes.

>inside
Log Cabin
A sparsely furnished log cabin, lit by electrical lighting. The door is to the east.

You can see a door to the cabin, a wooden trapdoor, three electric lights (providing light), a light switch, a moth-eaten old bed and an old wooden chest (in which are ten crackers and two flashlights) here.

>sleep
You sleep relatively soundly, and awaken the next morning.

* * *

>n
Highway
A dusty footpath that extends to the north and south.

You can see a bed here.

You see the sun set behind the horizon, and darkness falls across the land.

It is now pitch dark in here!

>sleep
There's nowhere to lay your head.

>s
Darkness
It is pitch dark, and you can't see a thing.

>inside
Log Cabin
A sparsely furnished log cabin, lit by electrical lighting. The door is to the east.

You can see a door to the cabin, a wooden trapdoor, three electric lights (providing light), a light switch, a moth-eaten old bed and an old wooden chest (in which are ten crackers and two flashlights) here.

* * *

>sleep
You sleep relatively soundly, and awaken the next morning.

>outside
(first getting off the moth-eaten old bed)

Darkness
It is pitch dark, and you can't see a thing.

* * *

>open door
It seems to be locked.

>unlock door
(with the black purse)
That doesn't seem to fit the lock.

>i
You are carrying:
  a black purse (closed)

>open purse
Dropped.

You open the black purse, revealing a basement key and a set of lockpicks.

>unlock door
What do you want to unlock the door to the cabin with?

>lockpick
You can't see any such thing.

>lockpicks
That's not a verb I recognise.

>unlock door
What do you want to unlock the door to the cabin with?

>lockpicks
(first taking the set of lockpicks)
You fiddle a bit, and the door to the cabin is unlocked.

>outside
(first opening the door to the cabin)
It seems to be locked.

* * *

>open purse
Dropped.

You open the black purse, revealing a basement key and a set of lockpicks.

* * *

>lockpicks
(first taking the set of lockpicks)
You fiddle a bit, and the door to the cabin is unlocked.

>put lockpicks in purse
You put the set of lockpicks into the black purse.

>take purse
You close the black purse.

Taken.

>outside
(first opening the door to the cabin)

Highway
You can see a door to the cabin here.

* * *

>outside
(first opening the door to the cabin)
It seems to be locked.

* * *

>z
Time passes.

You see the sun set behind the horizon, and darkness falls across the land.

>inside
Log Cabin
A sparsely furnished log cabin, lit by electrical lighting. The door is to the east.

You can see a door to the cabin, a wooden trapdoor, three electric lights (providing light), a light switch, a moth-eaten old bed and an old wooden chest (in which are ten crackers and two flashlights) here.

* * *

>z
Time passes.

You see the sun set behind the horizon, and darkness falls across the land.

>look
Highway
A dusty footpath that extends to the north and south.

You can see a door to the cabin here.

>z
Time passes.

It is now pitch dark in here!

* * *

>z
Time passes.

You see the sun set behind the horizon, and darkness falls across the land.

>z
Time passes.

It is now pitch dark in here!

>sleep
There's nowhere to lay your head.

>look
Darkness
It is pitch dark, and you can't see a thing.

>see
That's not a verb I recognise.

>n
Darkness
It is pitch dark, and you can't see a thing.

* * *

You awake with no memories of who you are.

Absurdist Octo-shrimp
An Interactive Fiction by Ethan Saff
Release 1 / Serial number 180326 / Inform 7 build 6M62 (I6/v6.33 lib 6/12N) SD

Log Cabin
A sparsely furnished log cabin, lit by electrical lighting. The door is to the east.

You can see a wooden trapdoor, a door to the cabin, three electric lights (providing light), a light switch, a moth-eaten old bed and an old wooden chest (closed) here.

>time
That's not a verb I recognise.

>check time
You can't see any such thing.

* * *

You awake with no memories of who you are.

Absurdist Octo-shrimp
An Interactive Fiction by Ethan Saff
Release 1 / Serial number 180326 / Inform 7 build 6M62 (I6/v6.33 lib 6/12N) SD

Log Cabin
A sparsely furnished log cabin, lit by electrical lighting. The door is to the east.

You can see a wooden trapdoor, a door to the cabin, three electric lights (providing light), a light switch, a moth-eaten old bed and an old wooden chest (closed) here.

>try entercellar
That's not a verb I recognise.

>test entercellar
(Testing.)

>[1] open chest
You open the old wooden chest, revealing ten crackers, three flashlights and a basement key.

>[2] take key
Taken.

>[3] take flashlight
Taken.

>[4] switch on flashlight
You switch the flashlight on.

>[5] unlock trapdoor with key
You unlock the wooden trapdoor.

>[6] down
(first opening the wooden trapdoor)

Cellar
An old cellar. Suprisingly, the food here has been kept relatively well preserved.

You can see a wooden trapdoor, a table (on which is a black purse (in which is a lockpicks)) and various foodstuffs here.

>take lockpicks
You're carrying too many things already.

>drop key
Dropped.

>take lockpick
You can't see any such thing.

>take lockpicks
Taken.

>up
Log Cabin
A sparsely furnished log cabin, lit by electrical lighting. The door is to the east.

You can see a wooden trapdoor, three electric lights (providing light), a light switch, a moth-eaten old bed, an old wooden chest (in which are ten crackers and two flashlights) and a door to the cabin here.

>open door
It seems to be locked.

>unlock door
What do you want to unlock the door to the cabin with?

* * *

>try entercellar
That's not a verb I recognise.

>try entercellar
That's not a verb I recognise.

>test entercellar
(Testing.)

>[1] open chest
You open the old wooden chest, revealing ten crackers, three flashlights and a basement key.

>[2] take key
Taken.

>[3] take flashlight
Taken.

>[4] switch on flashlight
You switch the flashlight on.

>[5] unlock trapdoor with key
You unlock the wooden trapdoor.

>[6] down
(first opening the wooden trapdoor)

Cellar
An old cellar. Suprisingly, the food here has been kept relatively well preserved.

You can see a wooden trapdoor, a table (on which is a tackle box (empty)) and various foodstuffs here.

* * *

You awake with no memories of who you are.

Absurdist Octo-shrimp
An Interactive Fiction by Ethan Saff
Release 1 / Serial number 180326 / Inform 7 build 6M62 (I6/v6.33 lib 6/12N) SD

Log Cabin
A sparsely furnished log cabin, lit by electrical lighting. The door is to the east.

You can see a wooden trapdoor, a door to the cabin, three electric lights (providing light), a light switch, a moth-eaten old bed and an old wooden chest (closed) here.

>w
When you try to go that way, you blunder into a wall.

>e
When you try to go that way, you blunder into a wall.

>s
When you try to go that way, you blunder into a wall.

>n
When you try to go that way, you blunder into a wall.

* * *

You awake with no memories of who you are.

Absurdist Octo-shrimp
An Interactive Fiction by Ethan Saff
Release 1 / Serial number 180326 / Inform 7 build 6M62 (I6/v6.33 lib 6/12N) SD

Log Cabin
A sparsely furnished log cabin, lit by electrical lighting. The door is to the east.

You can see a wooden trapdoor, a door to the cabin, three electric lights (providing light), a light switch, a moth-eaten old bed and an old wooden chest (closed) here.

>wai
That's not a verb I recognise.

* * *

You awake with no memories of who you are.

Absurdist Octo-shrimp
An Interactive Fiction by Ethan Saff
Release 1 / Serial number 180326 / Inform 7 build 6M62 (I6/v6.33 lib 6/12N) SD

Log Cabin
A sparsely furnished log cabin, lit by electrical lighting. The door is to the east.

You can see a wooden trapdoor, a door to the cabin, three electric lights (providing light), a light switch, a moth-eaten old bed and an old wooden chest (closed) here.

>wait
Time passes.

>wait
Time passes.

* * *

You awake with no memories of who you are.

Absurdist Octo-shrimp
An Interactive Fiction by Ethan Saff
Release 1 / Serial number 180326 / Inform 7 build 6M62 (I6/v6.33 lib 6/12N) SD

Log Cabin
A sparsely furnished log cabin, lit by electrical lighting. The door is to the east.

You can see a wooden trapdoor, a door to the cabin, three electric lights (providing light), a light switch, a moth-eaten old bed and an old wooden chest (closed) here.

>wake up
The dreadful truth is, this is not a dream.

* * *

You awake with no memories of who you are.

Absurdist Octo-shrimp
An Interactive Fiction by Ethan Saff
Release 1 / Serial number 180326 / Inform 7 build 6M62 (I6/v6.33 lib 6/12N) SD

Log Cabin
A sparsely furnished log cabin, lit by electrical lighting. The door is to the east.

You can see a wooden trapdoor, a door to the cabin, three electric lights (providing light), a light switch, a moth-eaten old bed and an old wooden chest (closed) here.

>z
Time passes.

>z
Time passes.

You begin to feel rather tired.

>z
Time passes.